FFFWFFFFFF
FFFWFWFWWF
FWWWFWFWWF
FFFFFWFFFF
WWWWFWWWWF
FWFWFFFFFF
FWFWFWWFWF
FFFFFWWFWF
FWWWFFFFWF
FFFWFWWFFF