FFFWFFFFFW
FFFWFWFWWF
FFFFFWFWWF
FFFFFWFFFF
WWWWFFFFWF
FWFWFFFFFF
FWFWFWWFWF
FFFFFWWFWF
FFFFFFFFWF
FFFWFWWFFF