FFFWFFFFFF
FFFWFWFFWW
WFWWFWFWWF
FFFWFFFFFF
WWFWFWWWWF
FWFFFFFFFF
FWFWFWWFWF
FFFFFWWFWF
FWWWFFWWWF
FFFWFWWFFF