FFFWFFFFFF
FFFWFWFWWF
FFFFFFFFFF
FFFFFWFFFF
FFFFFWFFFF
FWFWFWFFFF
FWFWFWFFWF
FFFFFWFFWF
FWFWFFFFWF
WFFWFWWFFF