FFFWFFFFFF
FFFWFWFWWF
FWWWFWFWWF
FFFFFWFFFF
WWWWFWWWWF
FWFWFFFFFF
FFFWWFFWFF
WWFFFFWWFF
FFFFFFFWWF
FFFFWWFFFF