FFFFFFFFFF
FFFFFWFWWF
FWFFFFFWWF
FWWFFFWFFF
WFFWFWWWWF
FWFFFFWWFF
FWFWFFFFWF
FFFFFWWFWF
FFFWFFFFWF
WFFWFWWFFF