FFFWFFFFFF
FFFWFWFWWF
FFFFFWFWWF
FFFFFWFFFF
FFFFFWWWWF
FWFWFFFFFF
WWWWFWWFWF
FFFFFFWFWF
FFFWFFFFWF
FFFWFWWFFF