FFFWFFFFFF
FFFFFFWWWF
FWWWFWFFWF
FFFWWFFFFF
WWFFFWWWWF
FFFFFFFFFF
FWFWFWWFWF
FFFFFWWFWF
FFFFFWWWWF
WWFFFFFFFF