FFFWFFFFFF
FFFWFWFWWF
FFFWFWFWWF
FFFWFWFFFF
FFWWFWWWWF
FFFWFFWFFF
FFFWFWWFWF
FFFFFWWFWF
FWFWFFFFWF
WFFWFWWFFF