FFFWFFWWFF
FFFWFWFWWF
FWWWFWFWWF
FFFFFWFFFF
WWWWFWWWWF
FWFWFFFWFF
FWFWFWWFWF
FFFFFWWFWF
WWWWFFFFWF
WWWWFWWFFF